101 101
=====================================================================================================
                                    =     =     =   =     = = =               = = = = =   =   =   = =
= = = === = ============= === = ===== ===== ===== === ===== = = ======= ======= = = = = === === === =
= = =   = =       =   = =   = = =       = =   = =         =           = = =               = = = = = =
=== = = === ======= === ========= ======= = === = ========= === ========= = =============== = = = = =
=   = = =           = =   =   = =                   = =   = = = = = = = =     = = =     =           =
=== ======= = = = === = === === = === ===== ========= = === = === = = = = ===== = = ===== ===========
=         = = = =       =   = =     =     =         = =         = =   =       = = = = = =     = =   =
= = = ======= === === === === = ===== =============== = ===== === = === ======= = = = = = ===== = ===
= = =   = =   =     =   =   =       =   =   = = = = =     = =             = = = = =   = =     =   = =
=== = === === === === === === =========== === = = = = ===== === === = = === = = = = === = ======= = =
=   = = =       = =       =                             = =   = = = = =               = =     =   = =
= = === === = === === = === ===== = = ======= = = = ===== = ===== ========= = = = = === = ======= = =
= =       = =   = =   =         = = =       = = = = = = =                 = = = = =         = = =   =
= = = === = = ======= = = = ===== === = = ======= === = = === === ===== = ========= = = = === = = ===
= = =   = = =   =     = = =     =   = = =     = =           =   =     = =     =     = = =           =
= === ======= ===== = = = = ========= === = === ======= = ========= ===== ======= = = = = === = = = =
= =       =       = = = = =       =     = =           = =         =     =   =     = = = =   = = = = =
= = = = = = = = = === ===== = ======= ===== = === = ===== = ======= =========== = ===== = ========= =
= = = = = = = = =   =     = =     = =     = =   = =   = = =     =           =   =     = =       =   =
= = === = = === = === = === = = === ========= = = = === ========= = ============= = = === ========= =
= =   = = = =   = =   =   = = =             = = = =             = = = = = =   = = = =   =         = =
= = = = = ===== = = = ===== = === = = === = = ===== = === = ========= = = === = ===== = = = = = === =
= = = = = =     = = =     = =   = = =   = = =     = =   = =       = = = =   =       = = = = = = = = =
= = = = ===== = = = = = === = = = === ======= = === = === = = = === = = = === ======= = === ===== ===
= = = = =     = = = = =   = = = =   =       = =   = = = = = = =                     = =   = = = = = =
= ===== === = = ===== = === === = =========== ========= === ======= = = = = ===== ===== ===== = = = =
=   = = =   = =     = =   = = = =       = = =             = = =   = = = = =     =     =   =         =
= === ===== === ===== = ===== === = = === = ======= = = ===== = ===== = === = === ===== === === = = =
= =         =       = =         = = =             = = =     =       = =   = =   = =   =       = = = =
=== ======= === = =================== === ======= ======= === === = = = = = = ===== ===== = =========
=   =         = =                   =   =       =       =       = = = = = = =           = =   =     =
= = ======= ===== = = === = = = = === === === ===== = ===== = =============== = === = === = === =====
= =   =         = = =   = = = = = =     =   =     = =     = =   = = = =   = = =   = = =   =         =
= = ======= ========= ===== = === = = === = = = ===== = === = === = = = === === = ===== = = = = = = =
= = = =         =         = =   = = =   = = = =     = =   = =                 = =     = = = = = = = =
===== ===== = ===== = = = = = = ===== ===== === ===== = ===== = = = = ================= === ======= =
=           =   =   = = = = = =     =     =   =     = =     = = = = =           =     =   =       = =
=== === = = = === = ======= ===== === = ===== = = ===== = = = = = === ===== ===== ===== === = === ===
= = =   = = =   = =       =     = =   =     = = =   =   = = = = = =       =           =   = =   =   =
= ===== ===== === = = ===== = ===== = = = ===== = ===== = = ========= = ===== = ======= === = ===== =
=         =     = = =     = =     = = = =     = =     = = =     =     =     = =       =   = =     = =
= === = ===== ======= ======= ================= = ======= = ========= = = ===== = ============= =====
= =   = =       =           = = = =         = = =       = =     =     = =     = =       =     = = = =
= === === = = = = = = ===== === = = === = === === = = ===== ===== === === =============== ======= = =
= =     = = = = = = =     =           = =       = = =   = =   = = =     =         =     =     = =   =
= === ======= === = ======= === = ======= = ========= === ===== ===== ============= ===== ===== = ===
= =   = = =     = =       =   = =     = = =         =             =             =           = =     =
= ===== = === ===== === === ===== = === === ===== = = = = = = = ===== = = = = === =========== = =====
= =               =   = =       = =   = = =     = = = = = = = =     = = = = =         =             =
= ===== = = = = = = ======= = ===== === = ===================== = = =========== = ===== === === = ===
= = =   = = = = = =     =   =   =               = = = = = =   = = =           = =     =   =   = =   =
=== === === === = = = === = = = === = = = ======= = = = = = =========== = = = === = === === ===== = =
=       =     = = = =   = = = = =   = = =         =   = =       =     = = = =   = =       =   =   = =
======= === = === ======= ===== = = = === = = ===== === = ======= ======= = = === = = = =========== =
=         = = =     =   =     = = = = =   = =         =     = =     =   = = =   = = = =     =   = = =
======= === = === === === = ======= = = = = = = === === ===== = ===== ======= === = = = ======= = ===
=   =     = = =         = = =   =   = = = = = =   = =               = = =   =   = = = =   = = =     =
=== === ========= = = ======= ===== = = = ===== ===== === = = = ===== = = === ========= === = = =====
=             =   = =     = =   =   = = = =             = = = =   =         =   = = = =       =     =
===== = = = = === = = ===== = ===== ===== === = === = ======= ===== === = ======= = = === ===== =====
=     = = = =   = = =     = = =   = =       = =   = =       =         = =     =   =     = = = =     =
===== ======= = === = ===== = = ======= = = === === = === === === = ======= ===== = ======= = = === =
=         =   =   = =                 = = = =     = =   =   =   = = = = = =   = = =   = = =       = =
= = = = ===== ======= === = = = === === = = = = = =================== = = ===== = = === = = =========
= = = =     =     =     = = = =   =   = = = = = =     = =           = = = = = = =             = =   =
= ===== ===== ===== = ===== === =========== = = = = === = === = ===== = = = = = = ======= ===== = ===
= =         =     = =     =   =     =     = = = = =         = =           =             =           =
= ===== = =========== = = = = = ===== === = === = = = = ========= = = = === === = === === === = =====
= = =   =           = = = = = =         = = =   = = = =         = = = =       = =   = =     = =     =
=== === = === = ============= = = = =========== = === = = === ===== = = = = ===== === === ===== =====
=       =   = =             = = = =   = =     = = =   = =   =     = = = = =     =   = = = = = =   = =
=== = = = = === = = = ===== === === === = ===== ===== = = = =============== = ========= === = ===== =
=   = = = =   = = = =     =   =   =           = =     = = =           =     = = = = = =             =
= = === =========== = = =========== = = = = = ===== = = === ===== ======= = === = = = === === ===== =
= = =         = = = = =           = = = = = =   =   = =   =     =     =   =           = =   = =   = =
= = === === === = ===== = = = ===== = === === === = = = ===== = = = ===== = === = ===== = ===== =====
= = =     = =       =   = = =     = =   =   = =   = = =     = = = =     = =   = =                 = =
= ===== ===== === ===== ===== ===== ===== = = === === = = ======= = ===== = = ===== === = = = ===== =
= =             =     =   =       =     = = = =     = = =     =   =     = = =     =   = = = =       =
= = = = = = = === = ===== = = = === ======= = = = = = === ======= = ========= = = = === ===== = = = =
= = = = = = =   = =     = = = =   =       = = = = = = =       =   =     = =   = = =   =     = = = = =
===== = = = ======= = ========= === ======= = = ========= = = === ======= === = ========= ===========
=     = = =       = = = = = =     =     = = = =       =   = = =             = =         =     = =   =
= = === === = ===== === = = === ========= ===== = = ===== ======= = === = ===== = === === = === = ===
= = =   =   =     =         =       =         = = =   =       =   =   = =   =   =   =   = =         =
= ========= = ===== = = = ===== = === ======= = = = ===== = ======= ===== === = = === === = = = = ===
= =         =     = = = =     = =   =       = = = =   =   = =           =   = = = = =   = = = = =   =
=== = === = = ======= = = = ========= ============= ===== = ======= ===== = === === ========= = = = =
=   = =   = =     = = = = =                   = =       = =   =         = = =             =   = = = =
=== ========= ===== === === = = === = ========= === = = === = === = = === = === = = ========= =======
=   =                 = =   = =   = =       =     = = =   = = =   = =   = = =   = =         =       =
============= === = = = === = = = === === ===== =================== ===== = === === === = === = = = =
=               = = = =   = = = =   =   =   = =   =   = = = =           = = =     =   = =   = = = = =
=== = ===== = = = ===== === = = = = = ======= = === === = = === = = = ===== = = === = = = = === = = =
=   = =     = = = = = = =   = = = = =                         = = = =     = = =   = = = = =   = = = =
=== ===== = = ===== = ===== = === = = = = = = = === = = = = ===== = = = ======= = ===== === = ===== =
=   =     = =             = =   = = = = = = = =   = = = = =     = = = =     =   =     = =   =     = =
=== = = = === ======= === = = ===== ===== = === ======= = = = = === = = = ===== = = === === = = = = =
=   = = = =         =   = = =     =     = = =         = = = = =   = = = =   =   = =   = =   = = = =  
=====================================================================================================
